#######################################################
#######################################################
##           #   #       #                     #   # ##
############ # ### # ### ################### ### ### ##
##   #       #     #   #         #   #         #     ##
## # # ####### ####### ######### # # # ####### ##### ##
## # #     #     #     #       #   #   #     #       ##
#### ##### # ##### ##### ##### ########### # ##### ####
##       # # #     #     # #   #           #     #   ##
#### ##### ### ####### ### # ### ############### ### ##
##         #   #       #         #             # # # ##
#### ####### ### ################### ######### # # # ##
##           #     #               #     #   #     # ##
################## ##### ### ### ##### ### # ####### ##
##     #         #     #   # #o    #   #   #   #     ##
###### ### # ### # ### ### # ####### ### ##### # ######
##       # #   # #   # #   #       # #   #   # # #   ##
## ### # ##### # ##### # ######### # # ##### # # # ####
## #   #       # #     #         #   #     # #   #   ##
## ############# # ########### ########### # ####### ##
##     #           # #         #         # #       # ##
#### # ### ######### # ######### ### ##### ##### # # ##
##   #   # #   #   # # #         # #     #   #   #   ##
######## # # # ### # # # ######### # ####### # ##### ##
##       # # # #     # #           #       #   #     ##
#### ####### # # ### # ########### ### ######### ######
##       #   # #   # #       #   # # #         #     ##
#### ### # ### ##### ####### ### # # ######### ### ####
## #   #     #   #   #           #     #       # # # ##
## ### ######### ### # ############### # ##### # # # ##
##   #         # # #   #   #       #   #   # #   # # ##
## ####### ##### # # # # # # ### ### ##### # ### # # ##
##   # #   #     # # # # # #   #     #   # #     #   ##
#### # # ### ##### # ### # ### ######### # # ##### ####
##     #   # #     # #   #   # #       # # #     #   ##
## ##### ### # ##### # ### ### # ##### # # ######### ##
##       #   #       # # #   # # # #   # #     #     ##
## # ##### ########### # # ### # # # ### ##### # ######
## #     #               #       #           #        #
#######################################################
